########################################
# 1                                    #
#                                      #
#         #######                      #
#         #                            #
#         #                            #
#         #######                      #
#                                      #
#                                      #
#                                      #
#    ###########                       #
#    #                                 #
#    #                                 #
#    ###########                       #
#                                      #
#                                      #
#                 ########             #
#                 #        #           #
#                 #        #           #
#                 #########            #
#                                      #
#                                      #
#         #######                      #
#         #                            #
#         #                            #
#         #######                      #
#                                      #
#                                      #
#                                      #
#                                      #
#                                      #
#     #####                            #
#     #                                #
#     #                                #
#     #####                            #
#                                      #
#                      2               #
#         #######                      #
#         #                            #
#         #                            #
########################################
