########################################
#               1                       #
#                                       #
#         #######                       #
#         #                             #
#         #                             #
#         #######                       #
#                                       #
#                                       #
#                                       #
#    ###########                        #
#    #                                  #
#    #                                  #
#    ###########                        #
#                                       #
#                                       #
#                 ########              #
#                 #        #            #
#                 #        #            #
############ #
#                                       #
#                                       #
#         #######                       #
#         #                             #
#         #                             #
#         #######                       #
#                                       #
#                                       #
#                  2                    #
#                                       #
#                                       #
#     #####                             #
#     #                                 #
#     #               ####              #
#     #####                             #
#                                       #
#                                       #
#         #######                       #
#         #                             #
#         #                             #
#########################################
