#########################################
# 1                                     #
#                                       #
#   ###########                         #
#   #                                   #
#   #                                   #
#   ###########                         #
#                                       #
#                                       #
#                                       #
#         #######                       #
#         #                             #
#         #                             #
#         #######                       #
#                                       #
#                                       #
#            #######                    #
#            #      #                   #
#            #      #                   #
##                                      #
#                                       #
#                                       #
#   ###########                         #
#   #                                   #
#   #                                   #
#   ###########                         #
#                                       #
#                                       #
#                         2             #
#                                       #
#                                       #
#       #######                         #
#       #                               #
#       #                               #
#       #######                         #
#                                       #
#                                       #
#            #######                    #
#            #      #                   #
#            #      #                   #
#########################################
