########################################
#                                      #
#                                      #
#         #######                      #
#         #                            #
#         #                            #
#         #######                      #
#                                      #
#                                      #
#            1                         #
#                         #########    #
#    #                                 #
#    #                                 #
#    ###########                       #
#                                      #
#                                      #
#                                      #
#                 #        #           #
#                 #        #           #
#                                      #
#                                      #
#                                      #
#         #######                      #
#         #                            #
#         #                            #
#         #######                      #
#                                      #
#                                      #
#                        2             #
#                                      #
#                                      #
#     #####                            #
#     #                                #
#     #                                #
#     #####                            #
#                                      #
#                                      #
#         #######                      #
#         #                            #
#         #                            #
########################################
