########################################
#                                      #
#                                      #
#         #######                      #
#         #                            #
#         #                            #
#         #######                      #
#                       2              #
#                                      #
#                                      #
#    ###########                       #
#    #                                 #
#    #                                 #
#    ###########                       #
#                                      #
#                                      #
#                 ########             #
#                          #           #
#                          #           #
#                      ####            #
#                                      #
#                                      #
#         #######                      #
#         #                            #
#         #                            #
#         #######                      #
#                                      #
#                                      #
#                                      #
#                                      #
#                                      #
#     #####                            #
#     #                                #
#     #                                #
#     #####                            #
#                                      #
#                     1                #
#         #######                      #
#         #                            #
#         #                            #
########################################
