########################################
#                                      #
#                                      #
#         #######                      #
#         #                            #
#         #                            #
#         #######                      #
#                                      #
#           2                          #
#                                      #
#    ###########                       #
#    #                                 #
#    #                                 #
#    ###########                       #
#                                      #
#                                      #
#    ########                          #
#                 #        #           #
#                 #        #           #
#                 #########            #
#                                      #
#                                      #
#                                      #
#         #                            #
#         #                            #
#                                      #
#                                      #
#                                      #
#                                      #
#                                      #
#                                      #
#     #####                            #
#     #                                #
#     #                                #
#     #####                            #
#                                      #
#                           1          #
#            ####                      #
#         #                            #
#         #                            #
########################################
